FFDmmDFFFFmM
FDmMMmDFDmMM
TTDMmDTTDmMM
TTTTTFFTTDmm
CFFFTTTTTTFT
OCFFFMMmFFFC
OOOCFMMFFFCO
OOOOOCFFCCOO
OOOOOOCCOOWO
OWOOWOOOOWOO
OOOOOOOOWOOO
OWOOOOWOOOOO